+.......................................................
+++.......++............+++....................*++++++..
..+...++++..+++.++++++++...+........#+........+.........
...+++.........+........+...++.....+..+......+..........
......+..................+....+...+....+......+..+++....
.......++*................++..*+++......+......++...+...
.........++.........+*++....+...........+..........+*...
........+..+.......+....+...+.........++*+++++......+...
.......++...+++*+++.....+...+.......+++..+....+......+..
.....+++.......+........+...+......+......+...+.......+.
.......+.......+.........+.+......+........+++.+#.....+.
.......*.......++++..+++++*+.....+.....+.........+...+..
......+.+.....+....++......+...++......+.........+..+...
....++...++..+.......++++...+++......++++++.......++....
..++.......++........+.....+............+...........+...
.............+......+.....+............+.++..........+..
..............++++++*+++++............+...............+.
.......................................................+